20;10
WWWWWWWWWWWWWWWWWWWW
WVHVVVVVVVVVVVVVVVVW
WVVVVVVVVVVVVVVVVVVW
WVVVVVVVVVVVVVVVVVVW
WVVVVVVVVVVVVVVVVVVW
WVVVVVVVVVVVVVVVVVVW
WVVVVVVVVVVVVVVVVVVW
WVVVVVVVVVVVVVVVVVVW
WVVVVVVVVVVVVVVVVVVW
WWWWWWWWWWWWWWWWWWWW
# Colonnes (Couleur; X; Y; YFin)
Rouge;1;2;4
Bleu;4;2;3