WWWWWWWWWWWWWWWWWWWW
WVHVVVVVVVVVVVVVVVVW
WVVVVVVVVVVVVVVVVVVW
WVVVVVVVVVVVVVVVVVVW
WVVVVVVVVVVVVVVVVVVW
WVVVVVVVVVVVVVVVCVVW
WVVVVVVVVVVVVVVVCVVW
WVVVVVVVVVVVVVVVCVVW
WVVVVVVVVVVVVVVVCVVW
WWWWWWWWWWWWWWWWWWWW
# Colonnes (Couleur; X; Y; YFin)
Rouge;1;2;4
Bleu;4;2;3