WWWWWWWWWWWWWWWWWWWW
WVHVVVVVVVVVVVVVVVVW
WVVVVVVVVVVVVVVVVVVW
WVVVVVVVVVVVVVVVVVVW
WVVVVVVVVVVVVVVVVVVW
WVVVVVVVVVVVVVVVVVVW
WVVVVVVVVVVVVVVVVVVW
WVVVVVVVVVVVVVVVVVVW
WVVVVVVVVVVVVVVVVVVW
WWWWWWWWWWWWWWWWWWWW