WWWWWWWWWW
WVVVVVVVVW
WVVVVVVVVW
WVVVVVVVVW
WVVVVVVVVW
WWWWWWWWWW
# Colonnes (Couleur; X; Y; YFin)
Rouge;1;1;3
Bleu;4;2;3