WWWWWWWWWWWWWWWWWWWW
WVHVVVVVVVVVVVVVVVVW
WVVVVVVVVVVVVVVVVVVW
WVVVVVVVVVVVVVVVVVVW
WVVVVVVVVVVVVVVVVVVW
WVVVVVVVVVVVVVVVVVVW
WVVVVVVVVVVVVVVVVVVW
WVVVVVVVVVVVVVVVVVVW
WVVVDVVVVDVVVVVDVVVW
WWWWWWWWWWWWWWWWWWWW